====================================================================================================
=                                                                          =========================
========                                                                                    ========
==========================================                                                        ==
===================================================================                                =
========================================                                                          ==
================================                                                             =======
======                                                                         =====================
==                                      ============================================================
=                                                        ===========================================
=                                                                               ====================
===                                                                                  ===============
=======                                                                                 ============
===============                                                                            =========
=========================================================                                      =====
================================================================================                   =
==========================================================================                         =
================================================                                                  ==
=======================                                                                          ===
======                                                                                        ======
=                                                                                    ===============
=====                                        =======================================================
============                 =======================================================================
=====##                                 ##==========================================================
=====                                                                   ##==========================
=#                                                                                                 =
=                                                                                                  =
=                                                                                                  =
=                                                                                                  =
=                                                                                                  =
=                                                                                                  =
=#                                                                                                #=
==##                                                                                        ##======
======####                                                                   ####===================
=========================###                                 ###====================================
================================================ ===================================================
====================================                        ========================================
=========================================    @        ==============================================
====================================================================================================
====================================================================================================