====================================================================================================
=                                                                         ####======================
========================================================  ==========================================
=====================================================###  ###=======================================
=====================================================###  ###=======================================
=====================================================###  ###=======================================
=====================================================###  ###=======================================
========================================================  ==========================================
============================                              ==========================================
=          @=================      =================================================================
===$$$====================     ==     ==============================================================
===   =====       =======   ========   =============================================================
====         === ======       ======   =============================================================
====#########===        #===========   =============================================================
=================================     ==============================================================
=========================               ==========================          ========================
============================           ====================                        =================
==============================                                                      ================
=======================================                                              ===============
=========================================================                             ==============
====================================================================               =================
============================================================                          ==============
============================================                             ===========================
=========================                                                       ====================
================                                                                        ============
========                                                                                  ==========
===                                                                                          =======
===                                                                                             ====
===                                                                                              ===
===                                                                                              ===
===                                                                                              ===
===                                                                                              ===
===                                                                                              ===
===#######################   ###################################=$=##############################===
===######################### ##################                  &###############################===
===#########################        ####         ################################################===
===################################      ########################################################===
==================================########==========================================================
====================================================================================================
====================================================================================================