====================================================================================================
= #################################################################################################=
= #####################################                           #################@      #########=
= ##################################### ######################### #######################  ########=
=  ##################                   ######################### ######      ############  #######=
=#                    ###########################################        #### #############  ######=
=############################################################################ ############## ######=
=############################################################################ ############## ######=
=######################################################                       ############## ######=
=###################################################### #################################### ######=
=#########################                              #################################### ######=
=#########                 ################################################################# ######=
=########  ################################################################################# ######=
=######## ################################################################################## ######=
=######## ################################################################################## ######=
=########                             ###################################################### ######=
=#################################### ###################################################### ######=
=#################################### ####################          ##################       ######=
=####################################                      ######## #################  ############=
=################################################################## ################  #############=
=################################################################## ###############  ##############=
=############################################                       ##############  ###############=
=###########################################  ###################################  ################=
=#############            #################  #################################### #################=
=############# ########## ################  ##################################### #################=
=##########    ########## ###############  ###################################### #################=
=#######    #############                 ####################################### #################=
=####### ######################################################################## #################=
=####### ######################################################################## #################=
=####### ######################################################################## #################=
=####### ######################################################################## #################=
=#######                                                           ############## #################=
=################################################################# ############## #################=
=################################################################# ############## #################=
=###############################                                   ############## #################=
=##############################  ################################################ #################=
=#############################  ################################################# #################=
=#############################                                                    #################=
=##################################################################################################=
====================================================================================================