====================================================================================================
=                                                 ==================================================
=======================================    =========================================================
=======================                        =====================================================
=============================  =====================================================================
======================            ============================    &  ===============================
==================                ==========================           =============================
===============                                                  ===================================
===========                       ==================================================================
=====                           ====================================================================
=         ==========================================================================================
=         ==========================================================================================
=         ==========================================================================================
=         ==========================================================================================
=         ==========================================================================================
=         ==========================================================================================
=         ==========================================================================================
=         ==================================================@=======================================
=         ================================================== =======================================
=         ================================================== =======================================
=         ===============================================       ====================================
=         ===========================================               ================================
=         =====================================                            =========================
=         =================================       ==================================================
=         ==============================     =======================================================
=         $$$$                                                    ==================================
=         $$$$                                          ============================================
=         ==========================================================================================
=#########==========================================================================================
=#########==========================================================================================
=#########==========================================================================================
====================================================================================================
====================================================================================================
====================================================================================================
====================================================================================================
====================================================================================================
====================================================================================================
====================================================================================================
====================================================================================================
====================================================================================================