====================================================================================================
=    ===============================================================================================
=        ==                                                                               $        =
=        ==   @                                                                           $        =
=        ==                                                                               $        =
=       ===================================================================================        =
=       ===================================================================================        =
=       ===================================================================================        =
=       ===================================================================================        =
=       ===================================================================================        =
=       ===================================================================================        =
=       ===================================================================================        =
=                                                           $                                      =
=######======================================           ===================================########=
=######======================================           ===================================########=
=######======================================           ===================================########=
=######======================================#         #===================================########=
===============================================       ==============================================
=#############################################          ###########################################=
=#  ####        ######      ##     #####                  ##########          #######          ####=
=    ##          ####        #       ###                    ######              ####            ###=
=    ##           ###        #        ##                      ###               ####            ###=
=     #           ##                  #                       ###               ###              ##=
=     #           ##                  #                        ##                ##              ##=
=     #           ##                  #                        ##                ##              ##=
=                 ##                  #                        ##                 #               #=
=                 ##                                           #                  #               #=
=                 #                                            #                  #                =
=#        &       #                                            #                                   =
=#                #                                            #                                  #=
=##                                                                                              ##=
=#####                                                                                       ######=
=##################################################################################################=
=##################################################################################################=
=##################################################################################################=
=##################################################################################################=
=##################################################################################################=
=##################################################################################################=
=##################################################################################################=
====================================================================================================